1111111111111
1001C000000C1
10C00111110C1
1P0011E00C001
1111111111111