1111111111111
1001000C000C1
10000111110C1
1P0011E0000C1
1111111111111