1111111111111111111111111111111111
1E0000000010000C00000C000000000001
1011110100100000101001011101110101
1010010010101010001001110110110101
1P0000000C00C0000C10000000000000C1
1111111111111111111111111111111111